00000000000000000000000000000000
00001111000000111111111110000000
00001000000000100000000010000000
00001000000000100000000010000000
00001111111111111111000011111111
00001000010000100000000010000000
00001000010000100000000010000000
11111000010000100000000010000000
00000011110000100000000010000000
00000010000000100022222212222222
00000011111111102220000010000000
00000000000000022000000010000000
00000000000000220000000010000000
00000000000000220011111111111000
00000000011111111110000100001000
00000000010003220000001100011110
00000000010000220000001301110000
00000111110000220000001000011100
00000100000000220000001000001000
00000100000002200000001000001000
00000100000022200000001001111100
00000100030022200000001000010000
00111111111111111111111000000000
00010000000222200000001000000000
00010000002222000000001000000000
00111000002222000000001000000000
00010000022222200000001000000000
00010022222222222201111111111111
22222222222222222222222222222222
22222222222222222222222222222222
22222222222222222222222222222222
22222222222222222222222222222222